NO graphics/north.xpm    
SO graphics/south.xpm   
WE graphics/west.xpm   
EA graphics/east.xpm    


C 225,0,0
F 220,100,0

1111111111111111
1000000100000001
1000000100000001
1100110000111011
1000000100000001
10000001000S0001
1111111111111111